1111111111111111
0000000100100101
1011110100000101
1010010001110001
1010110001010111
1011010100000001
1010010111101101
1000010100100101
1011011100101100
1001000000110001
1001001110001111
1011101000000001
1010001000110111
10110110111001dd
10000100101000dd
1111111111111111

