1111111111111111
111111111111000a
111111111111000a
1111111111110111
1111111111110111
1111111111110111
1111111111110111
1111111111110111
1111111111110111
1111111111110111
1111111000000111
1111111111111111
1111111111111111
1111111111111111
1111111111111111
1111111111111111

1111111111111111
a000000100100101
a011110100000101
1010010001110001
1010110001010111
1011010100000001
1010010111101101
1000010100100101
1011011100101100
1001000000110001
1001001110001111
1011101000000001
1010001000110111
1011011011100111
100001001010000b
1111111111111111

1111111111111111
1000000101110101
1011110100000100
1010010001110001
1010111101010111
1011010100000001
1010111111101101
1010010100100101
1011011110101101
1001010000110001
1001001111001111
1011101001000001
1010001001111111
1111011011101101
b000010010101101
1111111111111111