1111111111111111
111111111111000a
111111111111000a
1111111111110111
1111111111110111
1111111111110111
1111111111110111
1111111111110111
1111111111110111
1111111111110111
1111111000000111
1111111111111111
1111111111111111
1111111111111111
1111111111111111
1111111111111111

1111111111111111
a000000110011111
a000000110011111
1000000000000001
1111100000000001
1100100000000001
1000100000111001
1000100000111001
1110100000111001
100010000000000b
100000000000000b
1111100000000001
1000000000000001
1000000000000001
1000000000000001
1111111111111111

1111111111111111
111111111111000c
1111110000010111
1111110111010011
1111110001011011
1111111101010011
1111111101010111
1100000101010011
1100000101011011
b001110101010011
b001110101010111
1111110101010011
1111110001011011
1111111111000011
1111111111111111
1111111111111111

1111111111111111
c000000100100101
1011110100000101
1010010001110001
1010110001010111
1011010100000001
1010010111101101
1000010100100101
1011011100101100
1001000000110001
1001001110001111
1011101000000001
1010001000110111
1011011011100111
100001001010000d
1111111111111111

1111111111111111
1000000101110101
1011110100000100
1010010001110001
1010111101010111
1011010100000001
1010111111101101
1010010100100101
1011011110101101
1001010000110001
1001001111001111
1011101001000001
1010001001111111
1111011011101101
d000010010101101
1111111111111111