1111111111111111
111111111111000a
111111111111000a
1111111111110111
1111111111110111
1111111111110111
1111111111110111
1111111111110111
1111111111110111
1111111111110111
1111111000000111
1111111111111111
1111111111111111
1111111111111111
1111111111111111
1111111111111111

1111111111111111
a000000110011111
a000000110011111
1000000000000001
1111100000000001
1100100000000001
1000100000111001
1000100000111001
1110100000111001
100010000000000b
100000000000000b
1111100000000001
1000000000000001
1000000000000001
1000000000000001
1111111111111111

1111111111111111
111111111111000c
1111110000010111
1111110111010011
1111110001011011
1111111101010011
1111111101010111
1100000101010011
1100000101011011
b001110101010011
b001110101010111
1111110101010011
1111110001011011
1111111111000011
1111111111111111
1111111111111111

1111111111111111
c000000100100101
1011110100000101
1010010001110001
1010110001010111
1011010100000001
1010010111101101
1000010100100101
1011011100101100
1001000000110001
1001001110001111
1011101000000001
1010001000110111
1011011011100111
100001001010000d
1111111111111111

1111111111111111
1110001000100011
1000100010001011
1101111111111001
1001011000101001
1101010010001101
1001010111101101
11010101ee101001
1001010100101011
1100010000101011
1001011111101001
1101000000001101
1111111111111101
1001010000010001
d000000101000101
1111111111111111

1111111111111111
1111111010111111
1110111010111111
111000000010000f
1000111111101111
1110100000001111
1000101111101111
11101011ee100001
1000111100101101
1110110000001101
1000110111101101
1110110111101111
1110000000000101
1111011011011111
1111011011011111
1111111111111111

1111111111111111
1100011111010001
1111010000011101
f001000001000101
1101111011000111
1100010000011101
1110011101010001
1011000100010111
1001100111001011
1001110000000111
1100111101110001
1001101100010001
101101011011110g
100000001001010g
101011000011000g
1111111111111111

1111111111111111
1111111111111111
1111111111111111
1111111111111111
1111111111111111
1111111111111111
1111111111111111
1111111111111111
1111111111111111
1111111111111111
1111000100100011
1110000100100011
g000000100100011
g000000000000011
g000000000000011
1111111111111111
